//You need this blank line at the top, and an extra . at the end of every row.
*******...........
*.....*...........
*.....*...........
*.....*...........
*.....*...........
*.....*****d*****.
*...............*.
*...............*.
*...............*.
*...............*.
*...............*.
*************..**.
*************..**.
**.........**..**.
**.........**..**.
******d*****....*.
*..........*....*.
*..........*....*.
*..........d....*.
*..........*....*.
*..........*....*.
*************..**.
